AOM = "countries/AOM.txt"
AUH = "countries/AUH.txt"
BAD = "countries/BAD.txt"
CHI = "countries/CHI.txt"
GUX = "countries/GUX.txt"
GUZ = "countries/GUZ.txt"
HOK = "countries/HOK.txt"
MAN = "countries/MAN.txt"
NAL = "countries/NAL.txt"
QDN = "countries/QDN.txt"
SHD = "countries/SHD.txt"
SIC = "countries/SIC.txt"
TIB = "countries/TIB.txt"
XIK = "countries/XIK.txt"
XIN = "countries/XIN.txt"
YUN = "countries/YUN.txt"
ZZZ = "countries/ZZZ.txt"
DPK = "countries/DPK.txt"
JAP = "countries/JAP.txt"
MEN = "countries/MEN.txt"
KOR = "countries/KOR.txt"
TAW = "countries/TAW.txt"
WZS = "countries/WZS.txt"
SHT = "countries/SHT.txt"
SHX = "countries/SHX.txt"
QFK = "countries/QFK.txt"
DRV = "countries/DRV.txt"
ROV = "countries/ROV.txt"
KCD = "countries/KCD.txt"
KCJ = "countries/KCJ.txt"